as|asdf|around|
vim|vimtex_view_method|around|
ul|ultisnips|around|
coc|coc#pum#next|around|
coc#pum|coc#pum#visible|around|
Ta|TAB|around|
ex|expr|around|
inorema|inoremap|around|
do|document|around|
doc|document|around|
sdfadsf|sdfadsf|around|
docu|document|around|
do|document|around|
s|space|around|
hi|highlighting|around|
sy|syntax|around|
i3|i3lock|around|
st|startup|around|
exec|exec_always|around|
|bin|file|
te|temp.sh|file|
sc|scripts|file|
pol|polybar|file|
conf|config|around|
scrit|script|around|
sh|sh|file|
floa|floating|around|
for_wi|for_window|around|
rasterization|rasterization|around|
sty|style|around|
Iose|Iosevka|around|
pixel|pixelsize|around|
font|font|around|
capa|capacity|around|
star|startup|around|
exe|exec|around|
bind|bindsym|around|
exit|exit|jedi|f
sys|sys|jedi|M
sys|sys|jedi|M
i|import|jedi|k
exi|_exit|jedi|M
print|print|jedi|f
__name|__name__|jedi|v
if|if|jedi|k
o|os|jedi|M
impo|import|jedi|k
"|"\$schema": $1|json|m
